1111111111111111111111111111111
1PbBBBBBBBBBBBBBBBBBBBBBBBBBBB1
1BBBBBBBBBBBBBBBBBBBBBBBBBBBBB1
1BBBBBBBBBBBBBBBBBBBBBBBBBBBBB1
1BBBBBBBBBBBBBBBBBBBBBBBBBBBBB1
1BBBBBBBBBBBBBBBBBBBBBBBBBBBBB1
1BBBBBBBBBBBBBBBBBBBBBBBBBBBBB1
1BBBBBBBBBBBBBBBBBBBBBBBBBBBBB1
1BBBBBBBBBBBBBBBBBBBBBBBBBBBBB1
1BBBBBBBBBBBBBBBBBBBBBBBBBBBBB1
1BBBBBBBBBBBBBBBBBBBBBBBBBBBBB1
1BBBBBBBBBBBBBBBBBBBBBBBBBBBBE1
1111111111111111111111111111111