111111111111111111111111
1P0000001C0000000b00N001
10C0000010N000C001000001
1000000010000000010C0001
10N000001000000001000N01
10000C0010000N0001000001
100000001000C0000100C001
1C000000100000000100N001
10000N00b000N00001C000E1
111111111111111111111111