1111111111111111111111
1GC1B000000M0B01000001
1001B00000000001000101
1001111000000001G00101
1001b0M00N000001000101
1001111000000001000101
10000000M0000001000101
100111100N000001000101
1001B0M0000000000001P1
1001111011111111111111
1001b0000000D00000D001
10E1b000000000000000C1
1111111111111111111111