1111111111111111111
1B00100M000010M0001
100P10001000101b0b1
1M0010GM100N101b0b1
1b0010001000101b0b1
100b1b001M00101B0B1
1M00100010G0101B0B1
1000100b1000101b0B1
10001M0010M0101B0B1
10M0100b1000101B0B1
1b0010001000101BNb1
10001B001000101B0B1
10M0100010D0101B0B1
10M000M01N00001CEC1
1111111111111111111