1111111111111111111111111111111111
1P000100C0100000000000000000000001
1000010000010000000000000000000001
1000011110110000000000000000000001
1000000000000000000000000000000001
1000000000000000000000000000000001
1000000000000G00000000000000000001
100000000000000000000000000N000001
1000000000000000M00000000000000001
1000000000000000000000000000000001
1000000000000000000000000000000001
1000000000000000000b00000000000001
1000000000000000000000000000000001
1000000000000000000B00000000000001
10000000E0000000000000000000000001
1111111111111111111111111111111111