11111111111111111111
111111111111111111E1
100D00C000D00000B0b1
10000000C000000000B1
10111111111111111111
100M0000M0000M000001
11111111111111111bb1
1000M0000M00000C0D01
1000M000M000M000M001
1BbB1111111111111111
10C00M00000110000011
10000000M0011000D0b1
1P000000000C000000b1
11111111111111111111