11111111111111111111111111111
10M000M00000M0000M00000M00001
10110111111111111111111111101
10110001111111111111111111101
10111100BM00M00BM0M00BM0C1101
101C1111C111111C11111C1111101
10101111111111111111111111101
10100000M000M00000M0000000MC1
10101111111111111111111111111
101B000M000000P0000000M0000B1
10101111111111011111111111101
1010111111C1110111C1111111101
1C1C00000M0111E1110000000BB01
11111111111111111111111111111