111111111111111111111111
10010000000C100000000001
1000011111000M00B0C00001
1P0011C00B00100B00000001
111111111111100000M00001
1C00M0000B00M00011110001
11111E100bb0b00000000001
111111111111111111111111