1111111
1P00001
1C00011
1E00C01
1111111